S No,User,Analysis On,Total Question,Correct,Incorrect Or Not Attempted
1,goravchaurasia,subject: Mathematics,20,3,17
1,goravchaurasia,topic: Parity,2,1,1
1,goravchaurasia,subtopic: Logical Thinking,2,1,1
1,goravchaurasia,skill: Parity,2,1,1
1,goravchaurasia,dificulty: Medium,8,2,6
1,goravchaurasia,dificulty: Easy,8,1,7
1,goravchaurasia,topic: Pigeonhole Principle,2,1,1
1,goravchaurasia,subtopic: Combinatorics,8,2,6
1,goravchaurasia,skill: Pigeonhole Principle,2,1,1
1,goravchaurasia,dificulty: Hard,4,0,4
1,goravchaurasia,topic: Graph theory,1,0,1
1,goravchaurasia,skill: Graph Theory,1,0,1
1,goravchaurasia,topic: Set Theory,2,0,2
1,goravchaurasia,skill: Set Theory,2,0,2
1,goravchaurasia,topic: Elementary Algebra,1,0,1
1,goravchaurasia,subtopic: Algebra,4,0,4
1,goravchaurasia,skill: Elementary Algebra,1,0,1
1,goravchaurasia,topic: Divisibility,2,0,2
1,goravchaurasia,subtopic: Number Theory,2,0,2
1,goravchaurasia,skill: Divisibility,2,0,2
1,goravchaurasia,topic: Triginometry,1,0,1
1,goravchaurasia,subtopic: Geometry,1,0,1
1,goravchaurasia,skill: Trigonometry,1,0,1
1,goravchaurasia,topic: Probability,1,0,1
1,goravchaurasia,skill: Probability,1,0,1
1,goravchaurasia,topic: Game Theory,2,1,1
1,goravchaurasia,skill: Game Theory,2,1,1
1,goravchaurasia,topic: Application of derivatives,3,0,3
1,goravchaurasia,subtopic: Calculus,3,0,3
1,goravchaurasia,skill: Application of derivatives,3,0,3
1,goravchaurasia,topic: Linear Programming,3,0,3
1,goravchaurasia,skill: Linear Programming,3,0,3
2,dasguptasayon2020,subject: Mathematics,20,9,11
2,dasguptasayon2020,topic: Parity,2,1,1
2,dasguptasayon2020,subtopic: Logical Thinking,2,1,1
2,dasguptasayon2020,skill: Parity,2,1,1
2,dasguptasayon2020,dificulty: Medium,8,2,6
2,dasguptasayon2020,dificulty: Easy,8,6,2
2,dasguptasayon2020,topic: Pigeonhole Principle,2,0,2
2,dasguptasayon2020,subtopic: Combinatorics,8,4,4
2,dasguptasayon2020,skill: Pigeonhole Principle,2,0,2
2,dasguptasayon2020,dificulty: Hard,4,1,3
2,dasguptasayon2020,topic: Graph theory,1,0,1
2,dasguptasayon2020,skill: Graph Theory,1,0,1
2,dasguptasayon2020,topic: Set Theory,2,2,0
2,dasguptasayon2020,skill: Set Theory,2,2,0
2,dasguptasayon2020,topic: Elementary Algebra,1,1,0
2,dasguptasayon2020,subtopic: Algebra,4,1,3
2,dasguptasayon2020,skill: Elementary Algebra,1,1,0
2,dasguptasayon2020,topic: Divisibility,2,2,0
2,dasguptasayon2020,subtopic: Number Theory,2,2,0
2,dasguptasayon2020,skill: Divisibility,2,2,0
2,dasguptasayon2020,topic: Triginometry,1,0,1
2,dasguptasayon2020,subtopic: Geometry,1,0,1
2,dasguptasayon2020,skill: Trigonometry,1,0,1
2,dasguptasayon2020,topic: Probability,1,1,0
2,dasguptasayon2020,skill: Probability,1,1,0
2,dasguptasayon2020,topic: Game Theory,2,1,1
2,dasguptasayon2020,skill: Game Theory,2,1,1
2,dasguptasayon2020,topic: Application of derivatives,3,1,2
2,dasguptasayon2020,subtopic: Calculus,3,1,2
2,dasguptasayon2020,skill: Application of derivatives,3,1,2
2,dasguptasayon2020,topic: Linear Programming,3,0,3
2,dasguptasayon2020,skill: Linear Programming,3,0,3
3,chirag05122000,subject: Mathematics,20,9,11
3,chirag05122000,topic: Parity,2,0,2
3,chirag05122000,subtopic: Logical Thinking,2,0,2
3,chirag05122000,skill: Parity,2,0,2
3,chirag05122000,dificulty: Medium,10,4,6
3,chirag05122000,topic: Pigeonhole Principle,2,1,1
3,chirag05122000,subtopic: Combinatorics,8,5,3
3,chirag05122000,skill: Pigeonhole Principle,2,1,1
3,chirag05122000,topic: Graph theory,1,1,0
3,chirag05122000,skill: Graph Theory,1,1,0
3,chirag05122000,dificulty: Hard,5,2,3
3,chirag05122000,topic: Set Theory,2,1,1
3,chirag05122000,skill: Set Theory,2,1,1
3,chirag05122000,topic: Linear inequations,1,0,1
3,chirag05122000,subtopic: Algebra,4,0,4
3,chirag05122000,skill: Linear inequations,1,0,1
3,chirag05122000,dificulty: Easy,5,3,2
3,chirag05122000,topic: Divisibility,2,2,0
3,chirag05122000,subtopic: Number Theory,2,2,0
3,chirag05122000,skill: Divisibility,2,2,0
3,chirag05122000,topic: Triginometry,1,0,1
3,chirag05122000,subtopic: Geometry,1,0,1
3,chirag05122000,skill: Trigonometry,1,0,1
3,chirag05122000,topic: Probability,1,0,1
3,chirag05122000,skill: Probability,1,0,1
3,chirag05122000,topic: Game Theory,2,2,0
3,chirag05122000,skill: Game Theory,2,2,0
3,chirag05122000,topic: Application of derivatives,3,2,1
3,chirag05122000,subtopic: Calculus,3,2,1
3,chirag05122000,skill: Application of derivatives,3,2,1
3,chirag05122000,topic: Linear Programming,3,0,3
3,chirag05122000,skill: Linear Programming,3,0,3
4,Kamaljitmittal7637,subject: Mathematics,20,7,13
4,Kamaljitmittal7637,topic: Parity,2,2,0
4,Kamaljitmittal7637,subtopic: Logical Thinking,2,2,0
4,Kamaljitmittal7637,skill: Parity,2,2,0
4,Kamaljitmittal7637,dificulty: Medium,10,3,7
4,Kamaljitmittal7637,topic: Pigeonhole Principle,2,1,1
4,Kamaljitmittal7637,subtopic: Combinatorics,8,3,5
4,Kamaljitmittal7637,skill: Pigeonhole Principle,2,1,1
4,Kamaljitmittal7637,topic: Graph theory,1,0,1
4,Kamaljitmittal7637,skill: Graph Theory,1,0,1
4,Kamaljitmittal7637,dificulty: Hard,5,2,3
4,Kamaljitmittal7637,topic: Set Theory,2,1,1
4,Kamaljitmittal7637,skill: Set Theory,2,1,1
4,Kamaljitmittal7637,topic: Linear inequations,1,0,1
4,Kamaljitmittal7637,subtopic: Algebra,4,0,4
4,Kamaljitmittal7637,skill: Linear inequations,1,0,1
4,Kamaljitmittal7637,dificulty: Easy,5,2,3
4,Kamaljitmittal7637,topic: Divisibility,2,1,1
4,Kamaljitmittal7637,subtopic: Number Theory,2,1,1
4,Kamaljitmittal7637,skill: Divisibility,2,1,1
4,Kamaljitmittal7637,topic: Triginometry,1,0,1
4,Kamaljitmittal7637,subtopic: Geometry,1,0,1
4,Kamaljitmittal7637,skill: Trigonometry,1,0,1
4,Kamaljitmittal7637,topic: Probability,1,0,1
4,Kamaljitmittal7637,skill: Probability,1,0,1
4,Kamaljitmittal7637,topic: Game Theory,2,1,1
4,Kamaljitmittal7637,skill: Game Theory,2,1,1
4,Kamaljitmittal7637,topic: Application of derivatives,3,1,2
4,Kamaljitmittal7637,subtopic: Calculus,3,1,2
4,Kamaljitmittal7637,skill: Application of derivatives,3,1,2
4,Kamaljitmittal7637,topic: Linear Programming,3,0,3
4,Kamaljitmittal7637,skill: Linear Programming,3,0,3
5,aamir060601,subject: Mathematics,20,8,12
5,aamir060601,topic: Parity,2,2,0
5,aamir060601,subtopic: Logical Thinking,2,2,0
5,aamir060601,skill: Parity,2,2,0
5,aamir060601,dificulty: Medium,8,3,5
5,aamir060601,dificulty: Easy,8,3,5
5,aamir060601,topic: Pigeonhole Principle,2,2,0
5,aamir060601,subtopic: Combinatorics,8,4,4
5,aamir060601,skill: Pigeonhole Principle,2,2,0
5,aamir060601,dificulty: Hard,4,2,2
5,aamir060601,topic: Graph theory,1,0,1
5,aamir060601,skill: Graph Theory,1,0,1
5,aamir060601,topic: Set Theory,2,1,1
5,aamir060601,skill: Set Theory,2,1,1
5,aamir060601,topic: Elementary Algebra,1,0,1
5,aamir060601,subtopic: Algebra,4,0,4
5,aamir060601,skill: Elementary Algebra,1,0,1
5,aamir060601,topic: Divisibility,2,1,1
5,aamir060601,subtopic: Number Theory,2,1,1
5,aamir060601,skill: Divisibility,2,1,1
5,aamir060601,topic: Triginometry,1,0,1
5,aamir060601,subtopic: Geometry,1,0,1
5,aamir060601,skill: Trigonometry,1,0,1
5,aamir060601,topic: Probability,1,0,1
5,aamir060601,skill: Probability,1,0,1
5,aamir060601,topic: Game Theory,2,1,1
5,aamir060601,skill: Game Theory,2,1,1
5,aamir060601,topic: Application of derivatives,3,1,2
5,aamir060601,subtopic: Calculus,3,1,2
5,aamir060601,skill: Application of derivatives,3,1,2
5,aamir060601,topic: Linear Programming,3,0,3
5,aamir060601,skill: Linear Programming,3,0,3
6,Jpnoro2003,subject: Mathematics,20,13,7
6,Jpnoro2003,topic: Parity,2,2,0
6,Jpnoro2003,subtopic: Logical Thinking,2,2,0
6,Jpnoro2003,skill: Parity,2,2,0
6,Jpnoro2003,dificulty: Medium,8,3,5
6,Jpnoro2003,dificulty: Easy,8,7,1
6,Jpnoro2003,topic: Pigeonhole Principle,2,1,1
6,Jpnoro2003,subtopic: Combinatorics,8,6,2
6,Jpnoro2003,skill: Pigeonhole Principle,2,1,1
6,Jpnoro2003,dificulty: Hard,4,3,1
6,Jpnoro2003,topic: Graph theory,1,1,0
6,Jpnoro2003,skill: Graph Theory,1,1,0
6,Jpnoro2003,topic: Set Theory,2,2,0
6,Jpnoro2003,skill: Set Theory,2,2,0
6,Jpnoro2003,topic: Elementary Algebra,1,1,0
6,Jpnoro2003,subtopic: Algebra,4,2,2
6,Jpnoro2003,skill: Elementary Algebra,1,1,0
6,Jpnoro2003,topic: Divisibility,2,2,0
6,Jpnoro2003,subtopic: Number Theory,2,2,0
6,Jpnoro2003,skill: Divisibility,2,2,0
6,Jpnoro2003,topic: Triginometry,1,0,1
6,Jpnoro2003,subtopic: Geometry,1,0,1
6,Jpnoro2003,skill: Trigonometry,1,0,1
6,Jpnoro2003,topic: Probability,1,0,1
6,Jpnoro2003,skill: Probability,1,0,1
6,Jpnoro2003,topic: Game Theory,2,2,0
6,Jpnoro2003,skill: Game Theory,2,2,0
6,Jpnoro2003,topic: Application of derivatives,3,1,2
6,Jpnoro2003,subtopic: Calculus,3,1,2
6,Jpnoro2003,skill: Application of derivatives,3,1,2
6,Jpnoro2003,topic: Linear Programming,3,1,2
6,Jpnoro2003,skill: Linear Programming,3,1,2
7,dylan.dejonge0610,subject: Mathematics,20,10,10
7,dylan.dejonge0610,topic: Parity,2,1,1
7,dylan.dejonge0610,subtopic: Logical Thinking,2,1,1
7,dylan.dejonge0610,skill: Parity,2,1,1
7,dylan.dejonge0610,dificulty: Medium,8,3,5
7,dylan.dejonge0610,dificulty: Easy,8,5,3
7,dylan.dejonge0610,topic: Pigeonhole Principle,2,2,0
7,dylan.dejonge0610,subtopic: Combinatorics,8,5,3
7,dylan.dejonge0610,skill: Pigeonhole Principle,2,2,0
7,dylan.dejonge0610,dificulty: Hard,4,2,2
7,dylan.dejonge0610,topic: Graph theory,1,0,1
7,dylan.dejonge0610,skill: Graph Theory,1,0,1
7,dylan.dejonge0610,topic: Set Theory,2,1,1
7,dylan.dejonge0610,skill: Set Theory,2,1,1
7,dylan.dejonge0610,topic: Elementary Algebra,1,0,1
7,dylan.dejonge0610,subtopic: Algebra,4,1,3
7,dylan.dejonge0610,skill: Elementary Algebra,1,0,1
7,dylan.dejonge0610,topic: Divisibility,2,2,0
7,dylan.dejonge0610,subtopic: Number Theory,2,2,0
7,dylan.dejonge0610,skill: Divisibility,2,2,0
7,dylan.dejonge0610,topic: Triginometry,1,0,1
7,dylan.dejonge0610,subtopic: Geometry,1,0,1
7,dylan.dejonge0610,skill: Trigonometry,1,0,1
7,dylan.dejonge0610,topic: Probability,1,0,1
7,dylan.dejonge0610,skill: Probability,1,0,1
7,dylan.dejonge0610,topic: Game Theory,2,2,0
7,dylan.dejonge0610,skill: Game Theory,2,2,0
7,dylan.dejonge0610,topic: Application of derivatives,3,1,2
7,dylan.dejonge0610,subtopic: Calculus,3,1,2
7,dylan.dejonge0610,skill: Application of derivatives,3,1,2
7,dylan.dejonge0610,topic: Linear Programming,3,1,2
7,dylan.dejonge0610,skill: Linear Programming,3,1,2
8,canded.riya,subject: Mathematics,20,8,12
8,canded.riya,topic: Parity,2,1,1
8,canded.riya,subtopic: Logical Thinking,2,1,1
8,canded.riya,skill: Parity,2,1,1
8,canded.riya,dificulty: Medium,10,4,6
8,canded.riya,topic: Pigeonhole Principle,2,2,0
8,canded.riya,subtopic: Combinatorics,8,4,4
8,canded.riya,skill: Pigeonhole Principle,2,2,0
8,canded.riya,topic: Graph theory,1,0,1
8,canded.riya,skill: Graph Theory,1,0,1
8,canded.riya,dificulty: Hard,5,1,4
8,canded.riya,topic: Set Theory,2,1,1
8,canded.riya,skill: Set Theory,2,1,1
8,canded.riya,topic: Linear inequations,1,0,1
8,canded.riya,subtopic: Algebra,4,0,4
8,canded.riya,skill: Linear inequations,1,0,1
8,canded.riya,dificulty: Easy,5,3,2
8,canded.riya,topic: Divisibility,2,2,0
8,canded.riya,subtopic: Number Theory,2,2,0
8,canded.riya,skill: Divisibility,2,2,0
8,canded.riya,topic: Triginometry,1,0,1
8,canded.riya,subtopic: Geometry,1,0,1
8,canded.riya,skill: Trigonometry,1,0,1
8,canded.riya,topic: Probability,1,0,1
8,canded.riya,skill: Probability,1,0,1
8,canded.riya,topic: Game Theory,2,1,1
8,canded.riya,skill: Game Theory,2,1,1
8,canded.riya,topic: Application of derivatives,3,1,2
8,canded.riya,subtopic: Calculus,3,1,2
8,canded.riya,skill: Application of derivatives,3,1,2
8,canded.riya,topic: Linear Programming,3,0,3
8,canded.riya,skill: Linear Programming,3,0,3
9,bmaster251,subject: Mathematics,20,11,9
9,bmaster251,topic: Parity,2,1,1
9,bmaster251,subtopic: Logical Thinking,2,1,1
9,bmaster251,skill: Parity,2,1,1
9,bmaster251,dificulty: Medium,8,3,5
9,bmaster251,dificulty: Easy,8,7,1
9,bmaster251,topic: Pigeonhole Principle,2,2,0
9,bmaster251,subtopic: Combinatorics,8,7,1
9,bmaster251,skill: Pigeonhole Principle,2,2,0
9,bmaster251,dificulty: Hard,4,1,3
9,bmaster251,topic: Graph theory,1,0,1
9,bmaster251,skill: Graph Theory,1,0,1
9,bmaster251,topic: Set Theory,2,2,0
9,bmaster251,skill: Set Theory,2,2,0
9,bmaster251,topic: Elementary Algebra,1,1,0
9,bmaster251,subtopic: Algebra,4,1,3
9,bmaster251,skill: Elementary Algebra,1,1,0
9,bmaster251,topic: Divisibility,2,1,1
9,bmaster251,subtopic: Number Theory,2,1,1
9,bmaster251,skill: Divisibility,2,1,1
9,bmaster251,topic: Triginometry,1,0,1
9,bmaster251,subtopic: Geometry,1,0,1
9,bmaster251,skill: Trigonometry,1,0,1
9,bmaster251,topic: Probability,1,1,0
9,bmaster251,skill: Probability,1,1,0
9,bmaster251,topic: Game Theory,2,2,0
9,bmaster251,skill: Game Theory,2,2,0
9,bmaster251,topic: Application of derivatives,3,1,2
9,bmaster251,subtopic: Calculus,3,1,2
9,bmaster251,skill: Application of derivatives,3,1,2
9,bmaster251,topic: Linear Programming,3,0,3
9,bmaster251,skill: Linear Programming,3,0,3
10,isaacwbeh,subject: Mathematics,20,11,9
10,isaacwbeh,topic: Parity,2,2,0
10,isaacwbeh,subtopic: Logical Thinking,2,2,0
10,isaacwbeh,skill: Parity,2,2,0
10,isaacwbeh,dificulty: Medium,10,5,5
10,isaacwbeh,topic: Pigeonhole Principle,2,2,0
10,isaacwbeh,subtopic: Combinatorics,8,7,1
10,isaacwbeh,skill: Pigeonhole Principle,2,2,0
10,isaacwbeh,topic: Graph theory,1,0,1
10,isaacwbeh,skill: Graph Theory,1,0,1
10,isaacwbeh,dificulty: Hard,5,1,4
10,isaacwbeh,topic: Set Theory,2,2,0
10,isaacwbeh,skill: Set Theory,2,2,0
10,isaacwbeh,topic: Linear inequations,1,1,0
10,isaacwbeh,subtopic: Algebra,4,1,3
10,isaacwbeh,skill: Linear inequations,1,1,0
10,isaacwbeh,dificulty: Easy,5,5,0
10,isaacwbeh,topic: Divisibility,2,1,1
10,isaacwbeh,subtopic: Number Theory,2,1,1
10,isaacwbeh,skill: Divisibility,2,1,1
10,isaacwbeh,topic: Triginometry,1,0,1
10,isaacwbeh,subtopic: Geometry,1,0,1
10,isaacwbeh,skill: Trigonometry,1,0,1
10,isaacwbeh,topic: Probability,1,1,0
10,isaacwbeh,skill: Probability,1,1,0
10,isaacwbeh,topic: Game Theory,2,2,0
10,isaacwbeh,skill: Game Theory,2,2,0
10,isaacwbeh,topic: Application of derivatives,3,0,3
10,isaacwbeh,subtopic: Calculus,3,0,3
10,isaacwbeh,skill: Application of derivatives,3,0,3
10,isaacwbeh,topic: Linear Programming,3,0,3
10,isaacwbeh,skill: Linear Programming,3,0,3
11,aditi.270901,subject: Mathematics,20,0,20
11,aditi.270901,topic: Parity,2,0,2
11,aditi.270901,subtopic: Logical Thinking,2,0,2
11,aditi.270901,skill: Parity,2,0,2
11,aditi.270901,dificulty: Medium,10,0,10
11,aditi.270901,topic: Pigeonhole Principle,2,0,2
11,aditi.270901,subtopic: Combinatorics,8,0,8
11,aditi.270901,skill: Pigeonhole Principle,2,0,2
11,aditi.270901,topic: Graph theory,1,0,1
11,aditi.270901,skill: Graph Theory,1,0,1
11,aditi.270901,dificulty: Hard,5,0,5
11,aditi.270901,topic: Set Theory,2,0,2
11,aditi.270901,skill: Set Theory,2,0,2
11,aditi.270901,topic: Linear inequations,1,0,1
11,aditi.270901,subtopic: Algebra,4,0,4
11,aditi.270901,skill: Linear inequations,1,0,1
11,aditi.270901,dificulty: Easy,5,0,5
11,aditi.270901,topic: Divisibility,2,0,2
11,aditi.270901,subtopic: Number Theory,2,0,2
11,aditi.270901,skill: Divisibility,2,0,2
11,aditi.270901,topic: Triginometry,1,0,1
11,aditi.270901,subtopic: Geometry,1,0,1
11,aditi.270901,skill: Trigonometry,1,0,1
11,aditi.270901,topic: Probability,1,0,1
11,aditi.270901,skill: Probability,1,0,1
11,aditi.270901,topic: Game Theory,2,0,2
11,aditi.270901,skill: Game Theory,2,0,2
11,aditi.270901,topic: Application of derivatives,3,0,3
11,aditi.270901,subtopic: Calculus,3,0,3
11,aditi.270901,skill: Application of derivatives,3,0,3
11,aditi.270901,topic: Linear Programming,3,0,3
11,aditi.270901,skill: Linear Programming,3,0,3
12,gojkovic.ljubomir001,subject: Mathematics,20,8,12
12,gojkovic.ljubomir001,topic: Parity,2,2,0
12,gojkovic.ljubomir001,subtopic: Logical Thinking,2,2,0
12,gojkovic.ljubomir001,skill: Parity,2,2,0
12,gojkovic.ljubomir001,dificulty: Medium,10,4,6
12,gojkovic.ljubomir001,topic: Pigeonhole Principle,2,2,0
12,gojkovic.ljubomir001,subtopic: Combinatorics,8,5,3
12,gojkovic.ljubomir001,skill: Pigeonhole Principle,2,2,0
12,gojkovic.ljubomir001,topic: Graph theory,1,0,1
12,gojkovic.ljubomir001,skill: Graph Theory,1,0,1
12,gojkovic.ljubomir001,dificulty: Hard,5,1,4
12,gojkovic.ljubomir001,topic: Set Theory,2,1,1
12,gojkovic.ljubomir001,skill: Set Theory,2,1,1
12,gojkovic.ljubomir001,topic: Linear inequations,1,0,1
12,gojkovic.ljubomir001,subtopic: Algebra,4,0,4
12,gojkovic.ljubomir001,skill: Linear inequations,1,0,1
12,gojkovic.ljubomir001,dificulty: Easy,5,3,2
12,gojkovic.ljubomir001,topic: Divisibility,2,1,1
12,gojkovic.ljubomir001,subtopic: Number Theory,2,1,1
12,gojkovic.ljubomir001,skill: Divisibility,2,1,1
12,gojkovic.ljubomir001,topic: Triginometry,1,0,1
12,gojkovic.ljubomir001,subtopic: Geometry,1,0,1
12,gojkovic.ljubomir001,skill: Trigonometry,1,0,1
12,gojkovic.ljubomir001,topic: Probability,1,0,1
12,gojkovic.ljubomir001,skill: Probability,1,0,1
12,gojkovic.ljubomir001,topic: Game Theory,2,2,0
12,gojkovic.ljubomir001,skill: Game Theory,2,2,0
12,gojkovic.ljubomir001,topic: Application of derivatives,3,0,3
12,gojkovic.ljubomir001,subtopic: Calculus,3,0,3
12,gojkovic.ljubomir001,skill: Application of derivatives,3,0,3
12,gojkovic.ljubomir001,topic: Linear Programming,3,0,3
12,gojkovic.ljubomir001,skill: Linear Programming,3,0,3
13,alice.kuikota,subject: Mathematics,14,12,2
13,alice.kuikota,topic: Parity,2,2,0
13,alice.kuikota,subtopic: Logical Thinking,2,2,0
13,alice.kuikota,skill: Parity,2,2,0
13,alice.kuikota,dificulty: Hard,2,2,0
13,alice.kuikota,dificulty: Easy,8,7,1
13,alice.kuikota,topic: Combinations,1,1,0
13,alice.kuikota,subtopic: Combinatorics,5,5,0
13,alice.kuikota,skill: Combinations,1,1,0
13,alice.kuikota,topic: Pigeonhole Principle,1,1,0
13,alice.kuikota,skill: Pigeonhole Principle,1,1,0
13,alice.kuikota,topic: Elementary Algebra,3,2,1
13,alice.kuikota,subtopic: Algebra,5,3,2
13,alice.kuikota,skill: Elementary Algebra,3,2,1
13,alice.kuikota,topic: Linear inequations,1,1,0
13,alice.kuikota,skill: Linear inequations,1,1,0
13,alice.kuikota,dificulty: Medium,4,3,1
13,alice.kuikota,topic: Divisibility,2,2,0
13,alice.kuikota,subtopic: Number Theory,2,2,0
13,alice.kuikota,skill: Divisibility,2,2,0
13,alice.kuikota,topic: Set Theory,1,1,0
13,alice.kuikota,skill: Set Theory,1,1,0
13,alice.kuikota,topic: Series,1,0,1
13,alice.kuikota,skill: Series,1,0,1
13,alice.kuikota,topic: Game Theory,2,2,0
13,alice.kuikota,skill: Game Theory,2,2,0
14,Nikolina.kuhar000,subject: Mathematics,20,9,11
14,Nikolina.kuhar000,topic: Parity,2,1,1
14,Nikolina.kuhar000,subtopic: Logical Thinking,2,1,1
14,Nikolina.kuhar000,skill: Parity,2,1,1
14,Nikolina.kuhar000,dificulty: Medium,10,5,5
14,Nikolina.kuhar000,topic: Pigeonhole Principle,2,1,1
14,Nikolina.kuhar000,subtopic: Combinatorics,8,6,2
14,Nikolina.kuhar000,skill: Pigeonhole Principle,2,1,1
14,Nikolina.kuhar000,topic: Graph theory,1,0,1
14,Nikolina.kuhar000,skill: Graph Theory,1,0,1
14,Nikolina.kuhar000,dificulty: Hard,5,2,3
14,Nikolina.kuhar000,topic: Set Theory,2,2,0
14,Nikolina.kuhar000,skill: Set Theory,2,2,0
14,Nikolina.kuhar000,topic: Linear inequations,1,0,1
14,Nikolina.kuhar000,subtopic: Algebra,4,0,4
14,Nikolina.kuhar000,skill: Linear inequations,1,0,1
14,Nikolina.kuhar000,dificulty: Easy,5,2,3
14,Nikolina.kuhar000,topic: Divisibility,2,1,1
14,Nikolina.kuhar000,subtopic: Number Theory,2,1,1
14,Nikolina.kuhar000,skill: Divisibility,2,1,1
14,Nikolina.kuhar000,topic: Triginometry,1,0,1
14,Nikolina.kuhar000,subtopic: Geometry,1,0,1
14,Nikolina.kuhar000,skill: Trigonometry,1,0,1
14,Nikolina.kuhar000,topic: Probability,1,1,0
14,Nikolina.kuhar000,skill: Probability,1,1,0
14,Nikolina.kuhar000,topic: Game Theory,2,2,0
14,Nikolina.kuhar000,skill: Game Theory,2,2,0
14,Nikolina.kuhar000,topic: Application of derivatives,3,1,2
14,Nikolina.kuhar000,subtopic: Calculus,3,1,2
14,Nikolina.kuhar000,skill: Application of derivatives,3,1,2
14,Nikolina.kuhar000,topic: Linear Programming,3,0,3
14,Nikolina.kuhar000,skill: Linear Programming,3,0,3
15,Pushpak.aggarwal2119,subject: Mathematics,20,14,6
15,Pushpak.aggarwal2119,topic: Parity,2,2,0
15,Pushpak.aggarwal2119,subtopic: Logical Thinking,2,2,0
15,Pushpak.aggarwal2119,skill: Parity,2,2,0
15,Pushpak.aggarwal2119,dificulty: Medium,8,4,4
15,Pushpak.aggarwal2119,dificulty: Easy,8,7,1
15,Pushpak.aggarwal2119,topic: Pigeonhole Principle,2,2,0
15,Pushpak.aggarwal2119,subtopic: Combinatorics,8,5,3
15,Pushpak.aggarwal2119,skill: Pigeonhole Principle,2,2,0
15,Pushpak.aggarwal2119,dificulty: Hard,4,3,1
15,Pushpak.aggarwal2119,topic: Graph theory,1,0,1
15,Pushpak.aggarwal2119,skill: Graph Theory,1,0,1
15,Pushpak.aggarwal2119,topic: Set Theory,2,1,1
15,Pushpak.aggarwal2119,skill: Set Theory,2,1,1
15,Pushpak.aggarwal2119,topic: Elementary Algebra,1,1,0
15,Pushpak.aggarwal2119,subtopic: Algebra,4,3,1
15,Pushpak.aggarwal2119,skill: Elementary Algebra,1,1,0
15,Pushpak.aggarwal2119,topic: Divisibility,2,2,0
15,Pushpak.aggarwal2119,subtopic: Number Theory,2,2,0
15,Pushpak.aggarwal2119,skill: Divisibility,2,2,0
15,Pushpak.aggarwal2119,topic: Triginometry,1,1,0
15,Pushpak.aggarwal2119,subtopic: Geometry,1,1,0
15,Pushpak.aggarwal2119,skill: Trigonometry,1,1,0
15,Pushpak.aggarwal2119,topic: Probability,1,0,1
15,Pushpak.aggarwal2119,skill: Probability,1,0,1
15,Pushpak.aggarwal2119,topic: Game Theory,2,2,0
15,Pushpak.aggarwal2119,skill: Game Theory,2,2,0
15,Pushpak.aggarwal2119,topic: Application of derivatives,3,1,2
15,Pushpak.aggarwal2119,subtopic: Calculus,3,1,2
15,Pushpak.aggarwal2119,skill: Application of derivatives,3,1,2
15,Pushpak.aggarwal2119,topic: Linear Programming,3,2,1
15,Pushpak.aggarwal2119,skill: Linear Programming,3,2,1
16,kaustuv4006,subject: Mathematics,14,8,6
16,kaustuv4006,topic: Parity,2,1,1
16,kaustuv4006,subtopic: Logical Thinking,2,1,1
16,kaustuv4006,skill: Parity,2,1,1
16,kaustuv4006,dificulty: Hard,2,0,2
16,kaustuv4006,dificulty: Easy,8,6,2
16,kaustuv4006,topic: Combinations,1,1,0
16,kaustuv4006,subtopic: Combinatorics,5,4,1
16,kaustuv4006,skill: Combinations,1,1,0
16,kaustuv4006,topic: Pigeonhole Principle,1,0,1
16,kaustuv4006,skill: Pigeonhole Principle,1,0,1
16,kaustuv4006,topic: Elementary Algebra,3,2,1
16,kaustuv4006,subtopic: Algebra,5,3,2
16,kaustuv4006,skill: Elementary Algebra,3,2,1
16,kaustuv4006,topic: Linear inequations,1,0,1
16,kaustuv4006,skill: Linear inequations,1,0,1
16,kaustuv4006,dificulty: Medium,4,2,2
16,kaustuv4006,topic: Divisibility,2,0,2
16,kaustuv4006,subtopic: Number Theory,2,0,2
16,kaustuv4006,skill: Divisibility,2,0,2
16,kaustuv4006,topic: Set Theory,1,1,0
16,kaustuv4006,skill: Set Theory,1,1,0
16,kaustuv4006,topic: Series,1,1,0
16,kaustuv4006,skill: Series,1,1,0
16,kaustuv4006,topic: Game Theory,2,2,0
16,kaustuv4006,skill: Game Theory,2,2,0
17,amitozarsh,subject: Mathematics,20,6,14
17,amitozarsh,topic: Parity,2,1,1
17,amitozarsh,subtopic: Logical Thinking,2,1,1
17,amitozarsh,skill: Parity,2,1,1
17,amitozarsh,dificulty: Medium,10,3,7
17,amitozarsh,topic: Pigeonhole Principle,2,2,0
17,amitozarsh,subtopic: Combinatorics,8,4,4
17,amitozarsh,skill: Pigeonhole Principle,2,2,0
17,amitozarsh,topic: Graph theory,1,0,1
17,amitozarsh,skill: Graph Theory,1,0,1
17,amitozarsh,dificulty: Hard,5,1,4
17,amitozarsh,topic: Set Theory,2,1,1
17,amitozarsh,skill: Set Theory,2,1,1
17,amitozarsh,topic: Linear inequations,1,0,1
17,amitozarsh,subtopic: Algebra,4,0,4
17,amitozarsh,skill: Linear inequations,1,0,1
17,amitozarsh,dificulty: Easy,5,2,3
17,amitozarsh,topic: Divisibility,2,1,1
17,amitozarsh,subtopic: Number Theory,2,1,1
17,amitozarsh,skill: Divisibility,2,1,1
17,amitozarsh,topic: Triginometry,1,0,1
17,amitozarsh,subtopic: Geometry,1,0,1
17,amitozarsh,skill: Trigonometry,1,0,1
17,amitozarsh,topic: Probability,1,0,1
17,amitozarsh,skill: Probability,1,0,1
17,amitozarsh,topic: Game Theory,2,1,1
17,amitozarsh,skill: Game Theory,2,1,1
17,amitozarsh,topic: Application of derivatives,3,0,3
17,amitozarsh,subtopic: Calculus,3,0,3
17,amitozarsh,skill: Application of derivatives,3,0,3
17,amitozarsh,topic: Linear Programming,3,0,3
17,amitozarsh,skill: Linear Programming,3,0,3
18,vijaykasnia46,subject: Mathematics,20,2,18
18,vijaykasnia46,topic: Parity,2,0,2
18,vijaykasnia46,subtopic: Logical Thinking,2,0,2
18,vijaykasnia46,skill: Parity,2,0,2
18,vijaykasnia46,dificulty: Medium,8,1,7
18,vijaykasnia46,dificulty: Easy,8,0,8
18,vijaykasnia46,topic: Pigeonhole Principle,2,2,0
18,vijaykasnia46,subtopic: Combinatorics,8,2,6
18,vijaykasnia46,skill: Pigeonhole Principle,2,2,0
18,vijaykasnia46,dificulty: Hard,4,1,3
18,vijaykasnia46,topic: Graph theory,1,0,1
18,vijaykasnia46,skill: Graph Theory,1,0,1
18,vijaykasnia46,topic: Set Theory,2,0,2
18,vijaykasnia46,skill: Set Theory,2,0,2
18,vijaykasnia46,topic: Elementary Algebra,1,0,1
18,vijaykasnia46,subtopic: Algebra,4,0,4
18,vijaykasnia46,skill: Elementary Algebra,1,0,1
18,vijaykasnia46,topic: Divisibility,2,0,2
18,vijaykasnia46,subtopic: Number Theory,2,0,2
18,vijaykasnia46,skill: Divisibility,2,0,2
18,vijaykasnia46,topic: Triginometry,1,0,1
18,vijaykasnia46,subtopic: Geometry,1,0,1
18,vijaykasnia46,skill: Trigonometry,1,0,1
18,vijaykasnia46,topic: Probability,1,0,1
18,vijaykasnia46,skill: Probability,1,0,1
18,vijaykasnia46,topic: Game Theory,2,0,2
18,vijaykasnia46,skill: Game Theory,2,0,2
18,vijaykasnia46,topic: Application of derivatives,3,0,3
18,vijaykasnia46,subtopic: Calculus,3,0,3
18,vijaykasnia46,skill: Application of derivatives,3,0,3
18,vijaykasnia46,topic: Linear Programming,3,0,3
18,vijaykasnia46,skill: Linear Programming,3,0,3
19,angadsingh1729,subject: Mathematics,20,16,4
19,angadsingh1729,topic: Parity,2,2,0
19,angadsingh1729,subtopic: Logical Thinking,2,2,0
19,angadsingh1729,skill: Parity,2,2,0
19,angadsingh1729,dificulty: Medium,10,6,4
19,angadsingh1729,topic: Pigeonhole Principle,2,1,1
19,angadsingh1729,subtopic: Combinatorics,8,7,1
19,angadsingh1729,skill: Pigeonhole Principle,2,1,1
19,angadsingh1729,topic: Graph theory,1,1,0
19,angadsingh1729,skill: Graph Theory,1,1,0
19,angadsingh1729,dificulty: Hard,5,5,0
19,angadsingh1729,topic: Set Theory,2,2,0
19,angadsingh1729,skill: Set Theory,2,2,0
19,angadsingh1729,topic: Linear inequations,1,1,0
19,angadsingh1729,subtopic: Algebra,4,3,1
19,angadsingh1729,skill: Linear inequations,1,1,0
19,angadsingh1729,dificulty: Easy,5,5,0
19,angadsingh1729,topic: Divisibility,2,1,1
19,angadsingh1729,subtopic: Number Theory,2,1,1
19,angadsingh1729,skill: Divisibility,2,1,1
19,angadsingh1729,topic: Triginometry,1,1,0
19,angadsingh1729,subtopic: Geometry,1,1,0
19,angadsingh1729,skill: Trigonometry,1,1,0
19,angadsingh1729,topic: Probability,1,1,0
19,angadsingh1729,skill: Probability,1,1,0
19,angadsingh1729,topic: Game Theory,2,2,0
19,angadsingh1729,skill: Game Theory,2,2,0
19,angadsingh1729,topic: Application of derivatives,3,2,1
19,angadsingh1729,subtopic: Calculus,3,2,1
19,angadsingh1729,skill: Application of derivatives,3,2,1
19,angadsingh1729,topic: Linear Programming,3,2,1
19,angadsingh1729,skill: Linear Programming,3,2,1
20,Kamalpiyush3,subject: Mathematics,20,2,18
20,Kamalpiyush3,topic: Parity,2,1,1
20,Kamalpiyush3,subtopic: Logical Thinking,2,1,1
20,Kamalpiyush3,skill: Parity,2,1,1
20,Kamalpiyush3,dificulty: Medium,10,1,9
20,Kamalpiyush3,topic: Pigeonhole Principle,2,0,2
20,Kamalpiyush3,subtopic: Combinatorics,8,0,8
20,Kamalpiyush3,skill: Pigeonhole Principle,2,0,2
20,Kamalpiyush3,topic: Graph theory,1,0,1
20,Kamalpiyush3,skill: Graph Theory,1,0,1
20,Kamalpiyush3,dificulty: Hard,5,0,5
20,Kamalpiyush3,topic: Set Theory,2,0,2
20,Kamalpiyush3,skill: Set Theory,2,0,2
20,Kamalpiyush3,topic: Linear inequations,1,0,1
20,Kamalpiyush3,subtopic: Algebra,4,0,4
20,Kamalpiyush3,skill: Linear inequations,1,0,1
20,Kamalpiyush3,dificulty: Easy,5,1,4
20,Kamalpiyush3,topic: Divisibility,2,1,1
20,Kamalpiyush3,subtopic: Number Theory,2,1,1
20,Kamalpiyush3,skill: Divisibility,2,1,1
20,Kamalpiyush3,topic: Triginometry,1,0,1
20,Kamalpiyush3,subtopic: Geometry,1,0,1
20,Kamalpiyush3,skill: Trigonometry,1,0,1
20,Kamalpiyush3,topic: Probability,1,0,1
20,Kamalpiyush3,skill: Probability,1,0,1
20,Kamalpiyush3,topic: Game Theory,2,0,2
20,Kamalpiyush3,skill: Game Theory,2,0,2
20,Kamalpiyush3,topic: Application of derivatives,3,0,3
20,Kamalpiyush3,subtopic: Calculus,3,0,3
20,Kamalpiyush3,skill: Application of derivatives,3,0,3
20,Kamalpiyush3,topic: Linear Programming,3,0,3
20,Kamalpiyush3,skill: Linear Programming,3,0,3
21,ap40902,subject: Mathematics,20,8,12
21,ap40902,topic: Parity,2,2,0
21,ap40902,subtopic: Logical Thinking,2,2,0
21,ap40902,skill: Parity,2,2,0
21,ap40902,dificulty: Medium,10,4,6
21,ap40902,topic: Pigeonhole Principle,2,1,1
21,ap40902,subtopic: Combinatorics,8,4,4
21,ap40902,skill: Pigeonhole Principle,2,1,1
21,ap40902,topic: Graph theory,1,0,1
21,ap40902,skill: Graph Theory,1,0,1
21,ap40902,dificulty: Hard,5,0,5
21,ap40902,topic: Set Theory,2,0,2
21,ap40902,skill: Set Theory,2,0,2
21,ap40902,topic: Linear inequations,1,1,0
21,ap40902,subtopic: Algebra,4,1,3
21,ap40902,skill: Linear inequations,1,1,0
21,ap40902,dificulty: Easy,5,4,1
21,ap40902,topic: Divisibility,2,0,2
21,ap40902,subtopic: Number Theory,2,0,2
21,ap40902,skill: Divisibility,2,0,2
21,ap40902,topic: Triginometry,1,1,0
21,ap40902,subtopic: Geometry,1,1,0
21,ap40902,skill: Trigonometry,1,1,0
21,ap40902,topic: Probability,1,1,0
21,ap40902,skill: Probability,1,1,0
21,ap40902,topic: Game Theory,2,2,0
21,ap40902,skill: Game Theory,2,2,0
21,ap40902,topic: Application of derivatives,3,0,3
21,ap40902,subtopic: Calculus,3,0,3
21,ap40902,skill: Application of derivatives,3,0,3
21,ap40902,topic: Linear Programming,3,0,3
21,ap40902,skill: Linear Programming,3,0,3
22,ankushparcha11,subject: Mathematics,20,6,14
22,ankushparcha11,topic: Parity,2,2,0
22,ankushparcha11,subtopic: Logical Thinking,2,2,0
22,ankushparcha11,skill: Parity,2,2,0
22,ankushparcha11,dificulty: Medium,10,3,7
22,ankushparcha11,topic: Pigeonhole Principle,2,1,1
22,ankushparcha11,subtopic: Combinatorics,8,3,5
22,ankushparcha11,skill: Pigeonhole Principle,2,1,1
22,ankushparcha11,topic: Graph theory,1,0,1
22,ankushparcha11,skill: Graph Theory,1,0,1
22,ankushparcha11,dificulty: Hard,5,1,4
22,ankushparcha11,topic: Set Theory,2,1,1
22,ankushparcha11,skill: Set Theory,2,1,1
22,ankushparcha11,topic: Linear inequations,1,0,1
22,ankushparcha11,subtopic: Algebra,4,0,4
22,ankushparcha11,skill: Linear inequations,1,0,1
22,ankushparcha11,dificulty: Easy,5,2,3
22,ankushparcha11,topic: Divisibility,2,1,1
22,ankushparcha11,subtopic: Number Theory,2,1,1
22,ankushparcha11,skill: Divisibility,2,1,1
22,ankushparcha11,topic: Triginometry,1,0,1
22,ankushparcha11,subtopic: Geometry,1,0,1
22,ankushparcha11,skill: Trigonometry,1,0,1
22,ankushparcha11,topic: Probability,1,0,1
22,ankushparcha11,skill: Probability,1,0,1
22,ankushparcha11,topic: Game Theory,2,1,1
22,ankushparcha11,skill: Game Theory,2,1,1
22,ankushparcha11,topic: Application of derivatives,3,0,3
22,ankushparcha11,subtopic: Calculus,3,0,3
22,ankushparcha11,skill: Application of derivatives,3,0,3
22,ankushparcha11,topic: Linear Programming,3,0,3
22,ankushparcha11,skill: Linear Programming,3,0,3
23,kushgadia,subject: Mathematics,20,17,3
23,kushgadia,topic: Parity,2,2,0
23,kushgadia,subtopic: Logical Thinking,2,2,0
23,kushgadia,skill: Parity,2,2,0
23,kushgadia,dificulty: Medium,8,7,1
23,kushgadia,dificulty: Easy,8,7,1
23,kushgadia,topic: Pigeonhole Principle,2,2,0
23,kushgadia,subtopic: Combinatorics,8,8,0
23,kushgadia,skill: Pigeonhole Principle,2,2,0
23,kushgadia,dificulty: Hard,4,3,1
23,kushgadia,topic: Graph theory,1,1,0
23,kushgadia,skill: Graph Theory,1,1,0
23,kushgadia,topic: Set Theory,2,2,0
23,kushgadia,skill: Set Theory,2,2,0
23,kushgadia,topic: Elementary Algebra,1,1,0
23,kushgadia,subtopic: Algebra,4,3,1
23,kushgadia,skill: Elementary Algebra,1,1,0
23,kushgadia,topic: Divisibility,2,1,1
23,kushgadia,subtopic: Number Theory,2,1,1
23,kushgadia,skill: Divisibility,2,1,1
23,kushgadia,topic: Triginometry,1,1,0
23,kushgadia,subtopic: Geometry,1,1,0
23,kushgadia,skill: Trigonometry,1,1,0
23,kushgadia,topic: Probability,1,1,0
23,kushgadia,skill: Probability,1,1,0
23,kushgadia,topic: Game Theory,2,2,0
23,kushgadia,skill: Game Theory,2,2,0
23,kushgadia,topic: Application of derivatives,3,2,1
23,kushgadia,subtopic: Calculus,3,2,1
23,kushgadia,skill: Application of derivatives,3,2,1
23,kushgadia,topic: Linear Programming,3,2,1
23,kushgadia,skill: Linear Programming,3,2,1
24,jibraniqbal2003,subject: Mathematics,20,8,12
24,jibraniqbal2003,topic: Parity,2,1,1
24,jibraniqbal2003,subtopic: Logical Thinking,2,1,1
24,jibraniqbal2003,skill: Parity,2,1,1
24,jibraniqbal2003,dificulty: Medium,8,5,3
24,jibraniqbal2003,dificulty: Easy,8,3,5
24,jibraniqbal2003,topic: Pigeonhole Principle,2,1,1
24,jibraniqbal2003,subtopic: Combinatorics,8,5,3
24,jibraniqbal2003,skill: Pigeonhole Principle,2,1,1
24,jibraniqbal2003,dificulty: Hard,4,0,4
24,jibraniqbal2003,topic: Graph theory,1,0,1
24,jibraniqbal2003,skill: Graph Theory,1,0,1
24,jibraniqbal2003,topic: Set Theory,2,1,1
24,jibraniqbal2003,skill: Set Theory,2,1,1
24,jibraniqbal2003,topic: Elementary Algebra,1,0,1
24,jibraniqbal2003,subtopic: Algebra,4,0,4
24,jibraniqbal2003,skill: Elementary Algebra,1,0,1
24,jibraniqbal2003,topic: Divisibility,2,0,2
24,jibraniqbal2003,subtopic: Number Theory,2,0,2
24,jibraniqbal2003,skill: Divisibility,2,0,2
24,jibraniqbal2003,topic: Triginometry,1,1,0
24,jibraniqbal2003,subtopic: Geometry,1,1,0
24,jibraniqbal2003,skill: Trigonometry,1,1,0
24,jibraniqbal2003,topic: Probability,1,1,0
24,jibraniqbal2003,skill: Probability,1,1,0
24,jibraniqbal2003,topic: Game Theory,2,2,0
24,jibraniqbal2003,skill: Game Theory,2,2,0
24,jibraniqbal2003,topic: Application of derivatives,3,1,2
24,jibraniqbal2003,subtopic: Calculus,3,1,2
24,jibraniqbal2003,skill: Application of derivatives,3,1,2
24,jibraniqbal2003,topic: Linear Programming,3,0,3
24,jibraniqbal2003,skill: Linear Programming,3,0,3
25,gadiarinku,subject: Mathematics,14,7,7
25,gadiarinku,topic: Parity,2,1,1
25,gadiarinku,subtopic: Logical Thinking,2,1,1
25,gadiarinku,skill: Parity,2,1,1
25,gadiarinku,dificulty: Hard,2,0,2
25,gadiarinku,dificulty: Easy,8,6,2
25,gadiarinku,topic: Combinations,1,1,0
25,gadiarinku,subtopic: Combinatorics,5,3,2
25,gadiarinku,skill: Combinations,1,1,0
25,gadiarinku,topic: Pigeonhole Principle,1,0,1
25,gadiarinku,skill: Pigeonhole Principle,1,0,1
25,gadiarinku,topic: Elementary Algebra,3,1,2
25,gadiarinku,subtopic: Algebra,5,1,4
25,gadiarinku,skill: Elementary Algebra,3,1,2
25,gadiarinku,topic: Linear inequations,1,0,1
25,gadiarinku,skill: Linear inequations,1,0,1
25,gadiarinku,dificulty: Medium,4,1,3
25,gadiarinku,topic: Divisibility,2,2,0
25,gadiarinku,subtopic: Number Theory,2,2,0
25,gadiarinku,skill: Divisibility,2,2,0
25,gadiarinku,topic: Set Theory,1,0,1
25,gadiarinku,skill: Set Theory,1,0,1
25,gadiarinku,topic: Series,1,0,1
25,gadiarinku,skill: Series,1,0,1
25,gadiarinku,topic: Game Theory,2,2,0
25,gadiarinku,skill: Game Theory,2,2,0
26,ragvreka,subject: Mathematics,20,4,16
26,ragvreka,topic: Parity,2,1,1
26,ragvreka,subtopic: Logical Thinking,2,1,1
26,ragvreka,skill: Parity,2,1,1
26,ragvreka,dificulty: Medium,8,3,5
26,ragvreka,dificulty: Easy,8,0,8
26,ragvreka,topic: Pigeonhole Principle,2,2,0
26,ragvreka,subtopic: Combinatorics,8,3,5
26,ragvreka,skill: Pigeonhole Principle,2,2,0
26,ragvreka,dificulty: Hard,4,1,3
26,ragvreka,topic: Graph theory,1,0,1
26,ragvreka,skill: Graph Theory,1,0,1
26,ragvreka,topic: Set Theory,2,1,1
26,ragvreka,skill: Set Theory,2,1,1
26,ragvreka,topic: Elementary Algebra,1,0,1
26,ragvreka,subtopic: Algebra,4,0,4
26,ragvreka,skill: Elementary Algebra,1,0,1
26,ragvreka,topic: Divisibility,2,0,2
26,ragvreka,subtopic: Number Theory,2,0,2
26,ragvreka,skill: Divisibility,2,0,2
26,ragvreka,topic: Triginometry,1,0,1
26,ragvreka,subtopic: Geometry,1,0,1
26,ragvreka,skill: Trigonometry,1,0,1
26,ragvreka,topic: Probability,1,0,1
26,ragvreka,skill: Probability,1,0,1
26,ragvreka,topic: Game Theory,2,0,2
26,ragvreka,skill: Game Theory,2,0,2
26,ragvreka,topic: Application of derivatives,3,0,3
26,ragvreka,subtopic: Calculus,3,0,3
26,ragvreka,skill: Application of derivatives,3,0,3
26,ragvreka,topic: Linear Programming,3,0,3
26,ragvreka,skill: Linear Programming,3,0,3
27,cuentadesanti,subject: Mathematics,20,12,8
27,cuentadesanti,topic: Parity,2,2,0
27,cuentadesanti,subtopic: Logical Thinking,2,2,0
27,cuentadesanti,skill: Parity,2,2,0
27,cuentadesanti,dificulty: Medium,8,5,3
27,cuentadesanti,dificulty: Easy,8,4,4
27,cuentadesanti,topic: Pigeonhole Principle,2,1,1
27,cuentadesanti,subtopic: Combinatorics,8,4,4
27,cuentadesanti,skill: Pigeonhole Principle,2,1,1
27,cuentadesanti,dificulty: Hard,4,3,1
27,cuentadesanti,topic: Graph theory,1,1,0
27,cuentadesanti,skill: Graph Theory,1,1,0
27,cuentadesanti,topic: Set Theory,2,1,1
27,cuentadesanti,skill: Set Theory,2,1,1
27,cuentadesanti,topic: Elementary Algebra,1,1,0
27,cuentadesanti,subtopic: Algebra,4,3,1
27,cuentadesanti,skill: Elementary Algebra,1,1,0
27,cuentadesanti,topic: Divisibility,2,1,1
27,cuentadesanti,subtopic: Number Theory,2,1,1
27,cuentadesanti,skill: Divisibility,2,1,1
27,cuentadesanti,topic: Triginometry,1,1,0
27,cuentadesanti,subtopic: Geometry,1,1,0
27,cuentadesanti,skill: Trigonometry,1,1,0
27,cuentadesanti,topic: Probability,1,0,1
27,cuentadesanti,skill: Probability,1,0,1
27,cuentadesanti,topic: Game Theory,2,1,1
27,cuentadesanti,skill: Game Theory,2,1,1
27,cuentadesanti,topic: Application of derivatives,3,1,2
27,cuentadesanti,subtopic: Calculus,3,1,2
27,cuentadesanti,skill: Application of derivatives,3,1,2
27,cuentadesanti,topic: Linear Programming,3,2,1
27,cuentadesanti,skill: Linear Programming,3,2,1
28,surajg7588,subject: Mathematics,20,8,12
28,surajg7588,topic: Parity,2,2,0
28,surajg7588,subtopic: Logical Thinking,2,2,0
28,surajg7588,skill: Parity,2,2,0
28,surajg7588,dificulty: Medium,10,3,7
28,surajg7588,topic: Pigeonhole Principle,2,1,1
28,surajg7588,subtopic: Combinatorics,8,3,5
28,surajg7588,skill: Pigeonhole Principle,2,1,1
28,surajg7588,topic: Graph theory,1,0,1
28,surajg7588,skill: Graph Theory,1,0,1
28,surajg7588,dificulty: Hard,5,2,3
28,surajg7588,topic: Set Theory,2,1,1
28,surajg7588,skill: Set Theory,2,1,1
28,surajg7588,topic: Linear inequations,1,0,1
28,surajg7588,subtopic: Algebra,4,0,4
28,surajg7588,skill: Linear inequations,1,0,1
28,surajg7588,dificulty: Easy,5,3,2
28,surajg7588,topic: Divisibility,2,2,0
28,surajg7588,subtopic: Number Theory,2,2,0
28,surajg7588,skill: Divisibility,2,2,0
28,surajg7588,topic: Triginometry,1,0,1
28,surajg7588,subtopic: Geometry,1,0,1
28,surajg7588,skill: Trigonometry,1,0,1
28,surajg7588,topic: Probability,1,0,1
28,surajg7588,skill: Probability,1,0,1
28,surajg7588,topic: Game Theory,2,1,1
28,surajg7588,skill: Game Theory,2,1,1
28,surajg7588,topic: Application of derivatives,3,1,2
28,surajg7588,subtopic: Calculus,3,1,2
28,surajg7588,skill: Application of derivatives,3,1,2
28,surajg7588,topic: Linear Programming,3,0,3
28,surajg7588,skill: Linear Programming,3,0,3
29,tiwarishubhangi2003,subject: Mathematics,20,6,14
29,tiwarishubhangi2003,topic: Parity,2,2,0
29,tiwarishubhangi2003,subtopic: Logical Thinking,2,2,0
29,tiwarishubhangi2003,skill: Parity,2,2,0
29,tiwarishubhangi2003,dificulty: Medium,8,2,6
29,tiwarishubhangi2003,dificulty: Easy,8,3,5
29,tiwarishubhangi2003,topic: Pigeonhole Principle,2,2,0
29,tiwarishubhangi2003,subtopic: Combinatorics,8,3,5
29,tiwarishubhangi2003,skill: Pigeonhole Principle,2,2,0
29,tiwarishubhangi2003,dificulty: Hard,4,1,3
29,tiwarishubhangi2003,topic: Graph theory,1,0,1
29,tiwarishubhangi2003,skill: Graph Theory,1,0,1
29,tiwarishubhangi2003,topic: Set Theory,2,0,2
29,tiwarishubhangi2003,skill: Set Theory,2,0,2
29,tiwarishubhangi2003,topic: Elementary Algebra,1,0,1
29,tiwarishubhangi2003,subtopic: Algebra,4,0,4
29,tiwarishubhangi2003,skill: Elementary Algebra,1,0,1
29,tiwarishubhangi2003,topic: Divisibility,2,1,1
29,tiwarishubhangi2003,subtopic: Number Theory,2,1,1
29,tiwarishubhangi2003,skill: Divisibility,2,1,1
29,tiwarishubhangi2003,topic: Triginometry,1,0,1
29,tiwarishubhangi2003,subtopic: Geometry,1,0,1
29,tiwarishubhangi2003,skill: Trigonometry,1,0,1
29,tiwarishubhangi2003,topic: Probability,1,0,1
29,tiwarishubhangi2003,skill: Probability,1,0,1
29,tiwarishubhangi2003,topic: Game Theory,2,1,1
29,tiwarishubhangi2003,skill: Game Theory,2,1,1
29,tiwarishubhangi2003,topic: Application of derivatives,3,0,3
29,tiwarishubhangi2003,subtopic: Calculus,3,0,3
29,tiwarishubhangi2003,skill: Application of derivatives,3,0,3
29,tiwarishubhangi2003,topic: Linear Programming,3,0,3
29,tiwarishubhangi2003,skill: Linear Programming,3,0,3
30,bachtiarhafidz27,subject: Mathematics,20,12,8
30,bachtiarhafidz27,topic: Parity,2,1,1
30,bachtiarhafidz27,subtopic: Logical Thinking,2,1,1
30,bachtiarhafidz27,skill: Parity,2,1,1
30,bachtiarhafidz27,dificulty: Medium,10,6,4
30,bachtiarhafidz27,topic: Pigeonhole Principle,2,2,0
30,bachtiarhafidz27,subtopic: Combinatorics,8,7,1
30,bachtiarhafidz27,skill: Pigeonhole Principle,2,2,0
30,bachtiarhafidz27,topic: Graph theory,1,0,1
30,bachtiarhafidz27,skill: Graph Theory,1,0,1
30,bachtiarhafidz27,dificulty: Hard,5,3,2
30,bachtiarhafidz27,topic: Set Theory,2,2,0
30,bachtiarhafidz27,skill: Set Theory,2,2,0
30,bachtiarhafidz27,topic: Linear inequations,1,0,1
30,bachtiarhafidz27,subtopic: Algebra,4,2,2
30,bachtiarhafidz27,skill: Linear inequations,1,0,1
30,bachtiarhafidz27,dificulty: Easy,5,3,2
30,bachtiarhafidz27,topic: Divisibility,2,0,2
30,bachtiarhafidz27,subtopic: Number Theory,2,0,2
30,bachtiarhafidz27,skill: Divisibility,2,0,2
30,bachtiarhafidz27,topic: Triginometry,1,0,1
30,bachtiarhafidz27,subtopic: Geometry,1,0,1
30,bachtiarhafidz27,skill: Trigonometry,1,0,1
30,bachtiarhafidz27,topic: Probability,1,1,0
30,bachtiarhafidz27,skill: Probability,1,1,0
30,bachtiarhafidz27,topic: Game Theory,2,2,0
30,bachtiarhafidz27,skill: Game Theory,2,2,0
30,bachtiarhafidz27,topic: Application of derivatives,3,2,1
30,bachtiarhafidz27,subtopic: Calculus,3,2,1
30,bachtiarhafidz27,skill: Application of derivatives,3,2,1
30,bachtiarhafidz27,topic: Linear Programming,3,2,1
30,bachtiarhafidz27,skill: Linear Programming,3,2,1
31,spaceskaalien9,subject: Mathematics,20,6,14
31,spaceskaalien9,topic: Parity,2,2,0
31,spaceskaalien9,subtopic: Logical Thinking,2,2,0
31,spaceskaalien9,skill: Parity,2,2,0
31,spaceskaalien9,dificulty: Medium,8,1,7
31,spaceskaalien9,dificulty: Easy,8,4,4
31,spaceskaalien9,topic: Pigeonhole Principle,2,1,1
31,spaceskaalien9,subtopic: Combinatorics,8,3,5
31,spaceskaalien9,skill: Pigeonhole Principle,2,1,1
31,spaceskaalien9,dificulty: Hard,4,1,3
31,spaceskaalien9,topic: Graph theory,1,0,1
31,spaceskaalien9,skill: Graph Theory,1,0,1
31,spaceskaalien9,topic: Set Theory,2,0,2
31,spaceskaalien9,skill: Set Theory,2,0,2
31,spaceskaalien9,topic: Elementary Algebra,1,0,1
31,spaceskaalien9,subtopic: Algebra,4,0,4
31,spaceskaalien9,skill: Elementary Algebra,1,0,1
31,spaceskaalien9,topic: Divisibility,2,1,1
31,spaceskaalien9,subtopic: Number Theory,2,1,1
31,spaceskaalien9,skill: Divisibility,2,1,1
31,spaceskaalien9,topic: Triginometry,1,0,1
31,spaceskaalien9,subtopic: Geometry,1,0,1
31,spaceskaalien9,skill: Trigonometry,1,0,1
31,spaceskaalien9,topic: Probability,1,0,1
31,spaceskaalien9,skill: Probability,1,0,1
31,spaceskaalien9,topic: Game Theory,2,2,0
31,spaceskaalien9,skill: Game Theory,2,2,0
31,spaceskaalien9,topic: Application of derivatives,3,0,3
31,spaceskaalien9,subtopic: Calculus,3,0,3
31,spaceskaalien9,skill: Application of derivatives,3,0,3
31,spaceskaalien9,topic: Linear Programming,3,0,3
31,spaceskaalien9,skill: Linear Programming,3,0,3
32,Golda.abs,subject: Mathematics,20,10,10
32,Golda.abs,topic: Parity,2,2,0
32,Golda.abs,subtopic: Logical Thinking,2,2,0
32,Golda.abs,skill: Parity,2,2,0
32,Golda.abs,dificulty: Medium,8,3,5
32,Golda.abs,dificulty: Easy,8,4,4
32,Golda.abs,topic: Pigeonhole Principle,2,1,1
32,Golda.abs,subtopic: Combinatorics,8,6,2
32,Golda.abs,skill: Pigeonhole Principle,2,1,1
32,Golda.abs,dificulty: Hard,4,3,1
32,Golda.abs,topic: Graph theory,1,1,0
32,Golda.abs,skill: Graph Theory,1,1,0
32,Golda.abs,topic: Set Theory,2,2,0
32,Golda.abs,skill: Set Theory,2,2,0
32,Golda.abs,topic: Elementary Algebra,1,0,1
32,Golda.abs,subtopic: Algebra,4,2,2
32,Golda.abs,skill: Elementary Algebra,1,0,1
32,Golda.abs,topic: Divisibility,2,0,2
32,Golda.abs,subtopic: Number Theory,2,0,2
32,Golda.abs,skill: Divisibility,2,0,2
32,Golda.abs,topic: Triginometry,1,0,1
32,Golda.abs,subtopic: Geometry,1,0,1
32,Golda.abs,skill: Trigonometry,1,0,1
32,Golda.abs,topic: Probability,1,0,1
32,Golda.abs,skill: Probability,1,0,1
32,Golda.abs,topic: Game Theory,2,2,0
32,Golda.abs,skill: Game Theory,2,2,0
32,Golda.abs,topic: Application of derivatives,3,0,3
32,Golda.abs,subtopic: Calculus,3,0,3
32,Golda.abs,skill: Application of derivatives,3,0,3
32,Golda.abs,topic: Linear Programming,3,2,1
32,Golda.abs,skill: Linear Programming,3,2,1
33,a.hong.kong.math.lover,subject: Mathematics,14,10,4
33,a.hong.kong.math.lover,topic: Parity,2,1,1
33,a.hong.kong.math.lover,subtopic: Logical Thinking,2,1,1
33,a.hong.kong.math.lover,skill: Parity,2,1,1
33,a.hong.kong.math.lover,dificulty: Hard,2,0,2
33,a.hong.kong.math.lover,dificulty: Easy,8,7,1
33,a.hong.kong.math.lover,topic: Combinations,1,1,0
33,a.hong.kong.math.lover,subtopic: Combinatorics,5,4,1
33,a.hong.kong.math.lover,skill: Combinations,1,1,0
33,a.hong.kong.math.lover,topic: Pigeonhole Principle,1,0,1
33,a.hong.kong.math.lover,skill: Pigeonhole Principle,1,0,1
33,a.hong.kong.math.lover,topic: Elementary Algebra,3,2,1
33,a.hong.kong.math.lover,subtopic: Algebra,5,3,2
33,a.hong.kong.math.lover,skill: Elementary Algebra,3,2,1
33,a.hong.kong.math.lover,topic: Linear inequations,1,1,0
33,a.hong.kong.math.lover,skill: Linear inequations,1,1,0
33,a.hong.kong.math.lover,dificulty: Medium,4,3,1
33,a.hong.kong.math.lover,topic: Divisibility,2,2,0
33,a.hong.kong.math.lover,subtopic: Number Theory,2,2,0
33,a.hong.kong.math.lover,skill: Divisibility,2,2,0
33,a.hong.kong.math.lover,topic: Set Theory,1,1,0
33,a.hong.kong.math.lover,skill: Set Theory,1,1,0
33,a.hong.kong.math.lover,topic: Series,1,0,1
33,a.hong.kong.math.lover,skill: Series,1,0,1
33,a.hong.kong.math.lover,topic: Game Theory,2,2,0
33,a.hong.kong.math.lover,skill: Game Theory,2,2,0
